666111666
666131666
666101111
611120231
613025111
611112166
666613166
666611166