61111166666
61500166666
61022161116
61020161316
61110111316
66110000316
66100010016
66100011116
66111116666