661111111666
661000001116
611211100016
610502002016
610331020116
611331000166
661111111166