66111166
61100166
61520166
61120116
61102016
61320016
61331316
61111116