6611111666
6615011166
6610200166
6111010116
6131010016
6132001016
6130002016
6111111116