666611111116
666110010516
666100010016
666120202016
666102110016
611102010116
613333300166
611111111166